{
  "A Level 1 - 1": 
  {
    "RoomName": "Level 1",
    "Map":  [
             "I______________________________________I",
             "IOOOOOOOOOOOOOOOOOOOOOOOOOOOOOOOOOOOOOOI",
             "IOOOOOOOOOOOOOOOOOOOOOOOOOOOOOOOOOOOOOOI",
             "IOOO$OOOOOOOOOOOOOOOOOOOOOOOOOOOOOOOOOOI",
             "I_________________>>>>>>OOOOOOOOOOOOOOOI",
             "IOOOOOOOOOOOOOOOOOOOOOOOOOOOOOOOOOOOOOOI",
             "IOOOOOOOOOOOOOOOOOOOOOOOOOOOOOOOOOOOOOOI",
             "I_____________________!!!!!!OOOOOOOOOOOI",
             "IOOOOOOOOOOOOOOOOOOOOOOOOOOOOOOOOOOOOOOI",
             "I+OOOOOOOOOOOOOOOOOOOOOOOOOOOOOOOOOOOO%I",
             "I-------------------------------OOOOOOOI",
             "IOOOOOOOOOOOOOOOOOOOOOOOOOOOOOOOOOOOOOOI",
             "IOOOOOOOOOOOOOOOOOOOOOOOOOOOOOOOOOOOOOOI",
             "I_____________________________<<<<<<OOOI",
             "IOOOOOmOOOOOOOOOOOOOOOOOOOOOOOOOOOOOOOOI",
             "IOOOOOOO*@OOOOOOOOOOOOOOOOOOOOOOOOOOOOEI",
             "I_______________________________________"
            
            ]
  },

  "B The Milkman Conspiracy": 
   {
    "RoomName": "Level 2",
    "Map":  [
             "I______________________________________I",
             "IOOOOOOOOOOOOOOOOOOOOOOOOOOOOOOOOOOOOOOI",
             "IOOOOOOOOOOOOOOOOOOOOOOOOOOOOOOOOOOOOOOI",
             "IO$OOO$OOO$OOO$OOO$OOO$OOO$OOO$OOO$OOO$I",
             "IOHO_OHO_OHO_OHO_OHO_OHO_OHO_OHO_OHO_OHI",
             "IOHOOOHOOOHOOOHOOOHOOOHOOOHOOOHOOOHOOOHI",
             "IOHOOOHOOOHOOOHOOOHOOOHOOOHOOOHOOOHOOOHI",
             "IOHO_OHO_OHO_OHO_OHO_OHO_OHO_OHO_OHO_OHI",
             "IOHOOOHOOOHOOOHOOOHOOOHOOOHOOOHOOOHOOOHI",
             "IOHOOOHOOOHOOOHOOOHOOOHOOOHOOOHOOOHOOOHI",
             "IOHO_OHO_OHO_OHO_OHO_OHO_OHO_OHO_OHO_OHI",
             "IOHOOOHOOOHOOOHOOOHOOOHOOOHOOOHOOOHOOOHI",
             "IOHOOOHOOOHOOOHOOOHOOOHOOOHOOOHOOOHOOOHI",
             "IOHO_OHO_OHO_OHO_OHO_OHO_OHO_OHO_OHO_OHI",
             "IOHOOOHOOOHOOOHOOOHOOOHOOOHOOOHOOOHOOOHI",
             "IOHOD*HOOOHOOOHOOOHOOOHOOOHOOOHOOOHOEOHI",
             "________________________________________"
            ]
   },

  "C Water Temple": 
   {
    "RoomName": "Level 3",
    "Map":  [
             "I______________________________________I",
             "IOOOOOOOOOOOOOOOOOOOOOOOOOOOOOOOOOOOOOOI",
             "IOOOOOOOOOOOOOOOOOOOOOOOOOOOOOOOOOOOOOOI",
             "IOOOOOOOOOOOOOOOOOOOOOOOOOOOOOOOOOOOOOOI",
             "IOOOOOOOOOOOOOOOOOOOOOOOOOOOOOOOOOOOOOOI",
             "I*OOOOOOOOOOOOOOOOOOOOOOOOOOOOOOOOOOOOOI",
             "IOOOOOOOOOOOOOOOOOOOOOOOOOOOOOOOOOOOOOOI",
             "IOOOOOOOOOOOOOOOOOOOOOOOOOOOOOOOOOOOOOOI",
             "IOOOOOOOOOOOOOOOOOOOOOOOOOOOOOOOOOOOOOOI",
             "IOOOOOOOOOOOOOOOOOOOOOOOOOOOOOOOOOOOOOOI",
             "IOOOOOOOOOOOOOOOOOOOOOOOOOOOOOOOOOOOOOOI",
             "IOOOOOOOOOOOOOOOOOOOOOOOOOOOOOOOOOOOOOOI",
             "IOOOOOOOOOOOOOOOOOOOOOOOOOOOOOOOOOOOOOOI",
             "IDOOOOO$OOOOOO$OOOOO$OOOOO$OOOOO$OOOO$EI",
             "I__OOO!!!OOOOO!!!OOO!!!OOO!!!OOO!!!OO__I",
             "II+OOOOOOOOOOOOOOOOOOOOOOOOOOOOOOOOOO%II",
             "II+OOOOOOOOOOOOOOOOOOOOOOOOOOOOOOOOOO%II",
             "II+OOOOOOOOOOOOOOOOOOOOOOOOOOOOOOOOOO%II",
             "________________________________________"
            ]
   },

   "D GreenHillZone": 
   {
    "RoomName": "Level 4",
    "Map":  [
             "I______________________________________I",
             "IOOOOOOOOOOOOOOOOOOOOOOOOOOOOOOOOOOOOOOI",
             "IOOOOOOOOOOOOOOOOOOOOOOOOOOOOOOOOOOOOOOI",
             "I$OOOOOOOOOOOOOOOOOOOOOOOOOOOOOOOOOOOOOI",
             "I<<<<<<<<<<<<<<<<<<<<<<<<<<<<OOOOOOOOOOI",
             "IOOOOOOOOOOOOOOOOOOOOOOOOOOOOOOOOOOOOOOI",
             "IOOOOOOOOOOOOOOOOOOOOOOOOOOOOOOOOOOOOOOI",
             "IOOOOOOOOOO<<<<<<<<<<<<<<<<<<<<<<<<<<<<I",
             "IOOOOOOOOOOOOOOOOOOOOOOOOOOOOOOOOOOOOOOI",
             "IOOOOOOOOOOOOOOOOOOOOOOOOOOOOOOOOOOOOOOI",
             "I>>>>>>>>>>>>>>>>>>>>>>>>>>>>OOOOOOOOOOI",
             "IOOOOOOOOOOOOOOOOOOOOOOOOOOOOOOOOOOOOOOI",
             "IOOOOOOOOOOOOOOOOOOOOOOOOOOOOOOOOOOOOOOI",
             "IOOOOOOOOOO<<<<<<<<<<<<<<<<<<<<<<<<<<<<I",
             "IOOOOOOOOOOOOOOOOOOOOOOOOOOOOOOOOOOOOOOI",
             "ID@*OOOOOOOOOOOOOOOOOOOOOOOOOOOOOOOOOOOI",
             "I__>>>>>>>>>>>>>>>>>>>>>>>>>>>>>>>>>>>>I"
            ]
   }
}
